Pos,City,NWSL Team,MLS Team,NWSL Pld,MLS Pld,NWSL Points,MLS Points,Points,Pts/Pld
1,"Seattle, WA",Seattle Reign FC,Seattle Sounders FC,24,34,41,59,100,1.7
2,"Portland, OR",Portland Thorns FC,Portland Timbers,24,34,42,54,96,1.7
3,"Salt Lake City, UT",Utah Royals FC,Real Salt Lake,24,34,35,49,84,1.4
4,"Harrison, NJ",Sky Blue FC,New York Red Bulls,24,34,9,71,80,1.4
5,"Houston, TX",Houston Dash,Houston Dynamo,24,34,32,38,70,1.2
6,"Atlanta, GA",--,Atlanta United FC,0,34,0,69,69,2.0
6,"Chicago, IL",Chicago Red Stars,Chicago Fire,24,34,37,32,69,1.2
8,"Kansas City, MO/KS",--,Sporting Kansas City,0,34,0,62,62,1.8
8,"Washington, DC",Washington Spirit,D.C. United,24,34,11,51,62,1.1
10,"Orlando, FL",Orlando Pride,Orlando City SC,24,34,30,28,58,1.0
11,"Dallas, TX",--,FC Dallas,0,34,0,57,57,1.7
11,"Los Angeles, CA",--,Los Angeles FC,0,34,0,57,57,1.7
11,"Raleigh, NC",North Carolina Courage,--,24,0,57,0,57,2.4
14,"New York, NY",--,New York City FC,0,34,0,56,56,1.6
15,"Columbus, OH",--,Columbus Crew,0,34,0,51,51,1.5
16,"Philadelphia, PA",--,Philadelphia Union,0,34,0,50,50,1.5
17,"Carson, CA",--,LA Galaxy,0,34,0,48,48,1.4
18,"Vancouver, BC",--,Vancouver Whitecaps FC,0,34,0,47,47,1.4
19,"Montreal, QC",--,Montreal Impact,0,34,0,46,46,1.4
20,"Boston, MA",--,New England Revolution,0,34,0,41,41,1.2
21,"Milwaukee, MN",--,Minnesota United FC,0,34,0,36,36,1.1
21,"Toronto, ON",--,Toronto FC,0,34,0,36,36,1.1
23,"Denver, CO",--,Colorado Rapids,0,34,0,31,31,0.9
24,"San Jose, CA",--,San Jose Earthquakes,0,34,0,21,21,0.6